{
    "lilyRequirement": 3,
    "heightMap": [
        "000000000",
        "000000000",
        "000000000",
        "000000000",
        "000000000",
        "000000000",
        "000000000"
    ],
    "layer0": [
        "WWWWWWWWW",
        "WWWWWWWWW",
        "WWWWWWWWW",
        "WWWWWWWWW",
        "WWWWWWWWW",
        "WWWWWWWWW",
        "WWWWWWWWW"
    ],
    "layer1": [
        "000000000",
        "000R0L0L0",
        "000000000",
        "0R00LLR00",
        "000000000",
        "00000LR00",
        "000000000"
    ],
    "layer2": [
        "000000000",
        "000R0L0L0",
        "000000000",
        "0G00FLR00",
        "000000000",
        "00000LR00",
        "000000000"
    ]
}