{
    "heightMap": [
        "0000000",
        "0000000",
        "0000000",
        "0000000",
        "0000000",
        "0000000"
    ],
    "layer0": [
        "0000000",
        "0000000",
        "0000000",
        "0000000",
        "0000000",
        "0000000"
    ],
    "layer1": [
        "00000v0",
        "R0000^0",
        "00><0v0",
        "000v0^0",
        "0v0^000",
        "0^00000"
    ],
    "layer2": [
        "0000000",
        "0000000",
        "000F000",
        "0000000",
        "0000000",
        "0000000"
    ]
}