{
    "heightMap": [
        "00000",
        "00000",
        "00000",
        "00000",
        "00000",
        "00000"
    ],
    "layer1": [
        ".....",
        ".RRR.",
        "...R.",
        ".....",
        ".RRR.",
        "....."
    ],
    "layer2": [
        ".....",
        ".FRR.",
        "...R.",
        ".....",
        ".GRR.",
        "....."
    ]
}