{
    "size": {
        "x": 11,
        "y": 5
    },
    "heightMap": [
        "11011",
        "11011",
        "00000",
        "11011",
        "11011",
        "00000",
        "11011",
        "11011",
        "00000",
        "11011",
        "11011"
    ],
    "layer1": [
        "...L.",
        "LL..L",
        ".....",
        "LL.L.",
        "...L.",
        ".....",
        ".L.LL",
        "L....",
        ".....",
        "L...L",
        ".L.L."
    ],
    "layer2": [
        "...G.",
        "FL..L",
        ".....",
        "LL.L.",
        "...L.",
        ".....",
        ".L.LL",
        "L....",
        ".....",
        "L...L",
        ".L.L."
    ]
}