{
    "size": {
        "x": 13,
        "y": 10
    },
    "heightMap": [
        "0000000000",
        "0110110110",
        "0110110110",
        "0000000000",
        "0110110110",
        "0110110110",
        "0000000000",
        "0110110110",
        "0110110110",
        "0000000000",
        "0110110110",
        "0110110110",
        "0000000000"
    ],
    "layer1": [
        "0000000000",
        "01L01101L0",
        "0LL0LL01L0",
        "0000000000",
        "0L10LL0110",
        "01L0110L10",
        "0000000000",
        "01101L0LL0",
        "0LL0L10110",
        "0000000000",
        "0L101L01L0",
        "01L01L0L10",
        "0000000000"
    ],
    "layer2": [
        "0000000000",
        "01101101G0",
        "0LL0FL01L0",
        "0000000000",
        "01L0LL0L10",
        "0LL0110L10",
        "0000000000",
        "01101L0LL0",
        "0LL0L10110",
        "0000000000",
        "0L101L01L0",
        "01L01L0L10",
        "0000000000"
    ]
}