{
    "size": {
        "x": 7,
        "y": 13
    },
    "heightMap": [
        "0000000000000",
        "0000000000000",
        "0000000000000",
        "0000000000000",
        "0000000000000",
        "0000000000000",
        "0000000000000"
    ],
    "layer1": [
        "L.LL.........",
        ".............",
        "L..L.........",
        ".....LL..L...",
        "L....L.L.L.L.",
        "L.L.........L",
        "L.L.......L.."
    ],
    "layer2": [
        "L.LL.........",
        ".............",
        "L..L.........",
        ".....LL..L...",
        "L....L.F.L.L.",
        "L.L.........L",
        "L.L.......L.."
    ]
}