{
    "size": {
        "x": 6,
        "y": 8
    },
    "heightMap": [
        "00000000",
        "00000000",
        "00000000",
        "00000000",
        "XXXX0000",
        "XXXX0000"
    ],
    "layer1": [
        ".....LL.",
        ".....L.L",
        "..L..LL.",
        ".......L",
        "........",
        "......LL"
    ],
    "layer2": [
        ".....LL.",
        ".....F.L",
        "..G..LL.",
        ".......L",
        "........",
        "......LL"
    ]
}