{
    "size": {
        "x": 10,
        "y": 6
    },
    "heightMap": [
        "0011111100",
        "0000001100",
        "0000111100",
        "0000000000",
        "0000000000",
        "0000000000"
    ],
    "layer1": [
        "0000000L0R",
        "00R0000L0R",
        "0000000L0R",
        "00R0R0R00R",
        "R0L0L0L000",
        "0000000R00"
    ],
    "layer2": [
        "0000000L0R",
        "00R0000L0R",
        "0000000L0R",
        "00R0R0R00F",
        "R0L0L0L000",
        "0000000G00"
    ]
}