{
    "lilyRequirement": 12,
    "heightMap": [
        "110000",
        "110000",
        "110000",
        "110000",
        "110000",
        "111000",
        "111000"
    ],
    "layer0": [
        "110000",
        "110A00",
        "110000",
        "110000",
        "1100A0",
        "111000",
        "111000"
    ],
    "layer1": [
        "11R0R0",
        "R10L0R",
        "11LRL0",
        "R1L000",
        "R1ALAR",
        "X00L00",
        "XR0000"
    ],
    "layer2": [
        "R1R0F0",
        "R10L0R",
        "11LRL0",
        "R1L000",
        "R1ALAR",
        "X00L00",
        "XG0000"
    ]
}