{
    "lilyRequirement": 8,
    "heightMap": [
        "000000000",
        "000000000",
        "000000000",
        "000000000",
        "000000000"
    ],
    "layer0": [
        "000000000",
        "000000000",
        "000000000",
        "0AA0A00A0",
        "000000000"
    ],
    "layer1": [
        "0RR0R0000",
        "000000R00",
        "0LL0R0000",
        "RA>0A00A0",
        "000000000"
    ],
    "layer2": [
        "0FR0R0000",
        "000000G00",
        "0LL0R0000",
        "RA>0A00A0",
        "000000000"
    ]
}