{
    "lilyRequirement": 5,
    "heightMap": [
        "00000000",
        "00000000",
        "00000000",
        "00000000",
        "00000000",
        "00000000",
        "00000000"
    ],
    "layer0": [
        "00000000",
        "00A0A000",
        "00000000",
        "00000000",
        "00A0A000",
        "00000000",
        "00000000"
    ],
    "layer1": [
        "00000000",
        "R0L0A00R",
        "00000000",
        "0000L000",
        "00A0A0R0",
        "00000000",
        "00R00000"
    ],
    "layer2": [
        "00000000",
        "F0L0A00G",
        "00000000",
        "0000L000",
        "00A0A0R0",
        "00000000",
        "00R00000"
    ]
}