{
    "lilyRequirement": 5,
    "heightMap": [
        "1111111",
        "1111111",
        "1111111",
        "1111110",
        "1111110",
        "0000000",
        "0000000"
    ],
    "layer0": [
        "1111111",
        "1111111",
        "1111111",
        "1111110",
        "1111110",
        "0000000",
        "0000000"
    ],
    "layer1": [
        "111L111",
        "R0R1111",
        "1111111",
        "L0L111L",
        "11LLLL0",
        "000000R",
        "000RRR0"
    ],
    "layer2": [
        "111L111",
        "F0R1111",
        "1111111",
        "LLL111L",
        "11LLLL0",
        "000000G",
        "000RRR0"
    ]
}