{
    "lilyRequirement": 8,
    "heightMap": [
        "11111111",
        "11111111",
        "11111111",
        "11111110",
        "11111110",
        "XXXX0000",
        "XXXX0000"
    ],
    "layer0": [
        "11111111",
        "11111111",
        "11111111",
        "11111110",
        "11111110",
        "00000000",
        "00000000"
    ],
    "layer1": [
        "1111L111",
        "1R0R1111",
        "11111111",
        "1L0L111L",
        "111LLLL0",
        "0000000R",
        "0000RRR0"
    ],
    "layer2": [
        "1111L111",
        "1F0R1111",
        "11111111",
        "1LLL111L",
        "111LLLL0",
        "0000000G",
        "0000RRR0"
    ]
}