{
    "lilyRequirement": 6,
    "heightMap": [
        "22211000",
        "22211000",
        "22211000",
        "22211000",
        "11111000"
    ],
    "layer0": [
        "22211000",
        "22211000",
        "22211000",
        "22211000",
        "11111000"
    ],
    "layer1": [
        "22211000",
        "2R21L0R0",
        "2R2L10R0",
        "2R2L1000",
        "R11110R0"
    ],
    "layer2": [
        "22211000",
        "2F21L0R0",
        "2R2L10R0",
        "2R2L1000",
        "G11110R0"
    ]
}