{
    "lilyRequirement":  0,
    "heightMap": [
        "21222222",
        "20222222",
        "20222222",
        "20222222",
        "20222222",
        "20222222",
        "20222222",
        "10222222"
    ],
    "layer0": [
        "20222222",
        "20222222",
        "20222222",
        "2A222222",
        "2A222222",
        "20222222",
        "20222222",
        "20222222"
    ],
    "layer1": [
        "RRR2L22R",
        "2R2222LR",
        "R0222R22",
        "RARR22RR",
        "RLL2R22R",
        "R0L22R22",
        "RLL222RR",
        "R0222222"
    ],
    "layer2": [
        "R0R2L22R",
        "2R2222LR",
        "R0222G22",
        "RARR22RR",
        "RLL2R22R",
        "F0L22R22",
        "RLL222RR",
        "R0222222"
    ]
}