{
    "heightMap": [
        "000000000",
        "000000000",
        "000000000",
        "000000000",
        "000000000",
        "000000000",
        "000000000"
    ],
    "layer0": [
        "000000000",
        "00A0A0000",
        "000A0A000",
        "000000000",
        "00000A000",
        "00000A000",
        "000000000"
    ],
    "layer1": [
        "000R0RR00",
        "R000A0R00",
        "RR0L0LL0R",
        "R0L000000",
        "0R000AR00",
        "00RR0A000",
        "0000R0000"
    ],
    "layer2": [
        "000R0RR00",
        "R0L0A0R00",
        "FR0ALLL0R",
        "000000000",
        "0R000AR00",
        "000R0A000",
        "0000G0000"
    ]
}