{
    "size": {
        "x": 7,
        "y": 7
    },
    "heightMap": [
        "X11111X",
        "X11111X",
        "X11000X",
        "X11000X",
        "111000X",
        "111000X",
        "111000X"
    ],
    "layer1": [
        "X11111X",
        "X1L1L1X",
        "X1100RX",
        "X1L0L0X",
        "11R0L0X",
        "RL10R0X",
        "11R0R0X"
    ],
    "layer2": [
        "X11111X",
        "X1L1L1X",
        "X1LR00X",
        "X1L0L00",
        "11F0L0R",
        "GL10R00",
        "11R1000"
    ]
}