{
    "size": {
        "x": 7,
        "y": 6
    },
    "heightMap": [
        "0000000",
        "0000000",
        "0000000",
        "0000000",
        "0000000",
        "0000000"
    ],
    "layer1": [
        "0000000",
        "00RR0R0",
        "0R00000",
        "00000R0",
        "R00L0R0",
        "0000000"
    ],
    "layer2": [
        "0000000",
        "00FR0R0",
        "0G00000",
        "00000R0",
        "R00L0R0",
        "0000000"
    ]
}