{
    "lilyRequirement": 3,
    "heightMap": [
        "000000000",
        "000000000",
        "000000000",
        "000000000",
        "000000000",
        "000000000",
        "000000000"
    ],
    "layer0": [
        "WWWWWWWWW",
        "WWWWWWWWW",
        "WWWWWWWWW",
        "WWWWWWWWW",
        "WWWWWWWWW",
        "WWWWWWWWW",
        "WWWWWWWWW"
    ],
    "layer1": [
        "000000000",
        "00LL00000",
        "00L000000",
        "00RL00R00",
        "0R00000R0",
        "000L00000",
        "000000000"
    ],
    "layer2": [
        "000000000",
        "00LL00000",
        "00L000000",
        "00FL00G00",
        "0R00000R0",
        "000L00000",
        "000000000"
    ]
}