{
    "lilyRequirement":  10,
    "heightMap": [
        "000000000",
        "000000000",
        "000000000",
        "000000000",
        "000000000",
        "000000000"
    ],
    "layer0": [
        "000000000",
        "000000000",
        "000000000",
        "000000000",
        "000000000",
        "000000000"
    ],
    "layer1": [
        "000000v00",
        "000>00000",
        "000000000",
        "0L0LR0>00",
        "0R00R0000",
        "00000L0R0"
    ],
    "layer2": [
        "000000v00",
        "000>00000",
        "000000000",
        "0L0LR0>00",
        "0G00F0000",
        "00000L0R0"
    ]
}