{
    "lilyRequirement":  9,
    "heightMap": [
        "000000",
        "000000",
        "000000",
        "000000",
        "000000",
        "000000"
    ],
    "layer0": [
        "000000",
        "000000",
        "000000",
        "000A00",
        "000000",
        "000000"
    ],
    "layer1": [
        "000R00",
        "0R0v0R",
        "R00000",
        "R00000",
        "000000",
        "000RR0"
    ],
    "layer2": [
        "000R00",
        "0G0v0F",
        "R00000",
        "R00000",
        "000000",
        "000RR0"
    ]
}