{
    "lilyRequirement":  9,
    "heightMap": [
        "0000000",
        "0000000",
        "0000000",
        "0000000",
        "0000000",
        "0000000"
    ],
    "layer0": [
        "0000000",
        "0000000",
        "0000000",
        "0000000",
        "0000000",
        "0000000"
    ],
    "layer1": [
        "R0R000R",
        "R0v00R0",
        "0000000",
        "0000v0R",
        "00R000R",
        "0R00000"
    ],
    "layer2": [
        "R0R000G",
        "F0v00R0",
        "0000000",
        "0000v0R",
        "00R000R",
        "0R00000"
    ]
}