{
    "lilyRequirement":  0,
    "heightMap": [
        "0000000000",
        "0000000000",
        "0000000000",
        "0000000000",
        "0000000000",
        "0000000000",
        "0000000000"
    ],
    "layer0": [
        "0000000000",
        "0000000000",
        "000A000000",
        "000A000000",
        "0000A00000",
        "0000000000",
        "0000000000"
    ],
    "layer1": [
        "000R0R000R",
        "000R0v00R0",
        "R0LA000000",
        "RR0A000v0R",
        "00R0AL000R",
        "00R0L00R00",
        "0000000000"
    ],
    "layer2": [
        "000R0R000G",
        "000R0v00R0",
        "R0LA000000",
        "RR0A000v0R",
        "00R0AF000R",
        "00R0L00R00",
        "0000000000"
    ]
}