{
    "lilyRequirement":  14,
    "heightMap": [
        "2222221",
        "2222221",
        "2222221",
        "2222221",
        "0000001",
        "0000000",
        "0000000"
    ],
    "layer0": [
        "2222221",
        "222222A",
        "2222221",
        "222222A",
        "0000001",
        "000A000",
        "0000000"
    ],
    "layer1": [
        "2222221",
        "22L>221",
        "2R2222L",
        "R2RRR21",
        "R0L000L",
        "R0LL0L0",
        "00000L0"
    ],
    "layer2": [
        "R222221",
        "22L>221",
        "LG2222L",
        "22RR221",
        "R0L000L",
        "R0FL0L0",
        "00000L0"
    ]
}