{
    "lilyRequirement":  15,
    "heightMap": [
        "222XXX",
        "222111",
        "222111",
        "222000",
        "000002",
        "000002",
        "001111"
    ],
    "layer0": [
        "222XXX",
        "222111",
        "222111",
        "222000",
        "000002",
        "000002",
        "001111"
    ],
    "layer1": [
        "R22XXX",
        "22v1L1",
        "222LR1",
        "222000",
        "0>0>0R",
        "000002",
        "00L111"
    ],
    "layer2": [
        "R22XXX",
        "R2v1R1",
        "222LR1",
        "R22000",
        "0F0>0G",
        "000002",
        "00L111"
    ]
}