{
    "lilyRequirement":  0,
    "heightMap": [
        "222111",
        "222111",
        "222000",
        "000002",
        "000002",
        "000111"
    ],
    "layer0": [
        "222111",
        "222111",
        "222000",
        "000002",
        "000002",
        "000111"
    ],
    "layer1": [
        "R2v1L1",
        "222LR1",
        "R22000",
        "0>0>0R",
        "000002",
        "000L11"
    ],
    "layer2": [
        "R2v1R1",
        "222LR1",
        "R22000",
        "0F0>0G",
        "000002",
        "000L11"
    ]
}