{
    "lilyRequirement":  19,
    "heightMap": [
        "XXX00000000",
        "XXX00000000",
        "XXX00000000",
        "XX000000000",
        "XX000000000",
        "XX000000000",
        "XX000000000",
        "00000000000",
        "00000000000",
        "00000000000"
    ],
    "layer0": [
        "XXX00000000",
        "XXX00000000",
        "XXX00000000",
        "XX000000000",
        "XX000000000",
        "XX000000000",
        "XX000000000",
        "00000000000",
        "00000000000",
        "00000000000"
    ],
    "layer1": [
        "00000000000",
        "00000000000",
        "000000><0v0",
        "0000v0><0^0",
        "00><^><0><0",
        "000000><000",
        "00000000000",
        "00000000000",
        "0R000000000",
        "00000000000"
    ],
    "layer2": [
        "00000000000",
        "00000000000",
        "000000><0v0",
        "0000v0><0^0",
        "0000^F<0v00",
        "000000><^00",
        "00000000000",
        "00000000000",
        "0G000000000",
        "00000000000"
    ]
}