{
    "size": {
        "x": 13,
        "y": 13
    },
    "heightMap": [
        "0000000000000",
        "0000000000000",
        "0000000000000",
        "0000000000000",
        "0000000000000",
        "0000000000000",
        "0000000000000",
        "0000000000000",
        "0000000000000",
        "0000000000000",
        "0000000000000",
        "0000000000000",
        "0000000000000"
    ],
    "layer1": [
        ".............",
        ".R.L..R..L.R.",
        "..RR.........",
        ".L....L......",
        "..R........L.",
        ".............",
        ".R..L.R.L..R.",
        "...R.R.R.R...",
        ".L.....R...L.",
        ".....RL......",
        ".............",
        ".R.L..R.L..R.",
        "............."
    ],
    "layer2": [
        ".............",
        ".F.L..R..L.R.",
        ".............",
        "......L....L.",
        ".L...........",
        ".............",
        ".R.L..R.L..R.",
        ".............",
        "...........L.",
        ".L....L......",
        ".............",
        ".R.L..R.L..G.",
        "............."
    ]
}